EEEEEEEEEE
EEEEEEEEEE
EEEEEEEEEE
EEEEEEEEEE
BBEEEEEEEE
BBBBEEEEEE
BBBBBBBEEE
BBBBBBBBEE
EEEBBWBBEE
EEEEBBBEEE
