EBEEEEEEEE
EBBEEEEEEE
EEBBBLLBFF
EEEBBBEEFF
BBEBBBBEFF
BBBBBEEBBW
BBEBBBEBBB
EEEBBBEBBB
EEEEESEEEE
EEEEEBBBEE
