EEEEEEEEEE
EEEEEEEEEB
EEEEEEEEBB
BBSEEEEBBB
BBBFFLLBWB
BBBFFLLBBB
BBBEEEEBBB
BBBEEEEEBB
EEEEEEEEEB
EEEEEEEEEE
